▂                               _       
    ▂ ▐◘▌ ▂           ◢◘◣             /@\      
  ▄███▟█▙███▄     ◢█████████◣     /#=======#\  
 ▟▛ ▜█████▛ ▜▙   ◢◤ ◥█████◤ ◥◣   // \\-+-// \\ 
 █   ▐███▌   █   █   █████   █   #   )===(   # 
▟█▙  █▛▀▜█  ▟█▙ ◢█◣  █◤ ◥█  ◢█◣ /+\ (#/ \#) /+\
▜ ▛ ▟█   █▙ ▜ ▛ ◥ ◤  █   █  ◥ ◤ \ / ((   )) \ /
    ▜▌   ▐▛          █   █          ((   ))    
    ▂█   █▂         ◢█   █◣         /(   )\    
░░░░░░░░░░░░░░░░░░░░░░░░░░░░░░░░░░░░░░░░░░░░adl